1|0||0|100
2|0||0|120
3|0||0|140
4|0||0|160
5|0||0|180
6|0||0|200
7|0||0|220
8|0||0|240
9|0||0|260
10|0||0|280
